#######################################
# Syntax Coloring Map For IttyBitty
#######################################


#######################################
# Namespaces & Data Types (KEYWORD1)
#######################################

IttyBitty	KEYWORD1


# Types

# aliases

VOID	KEYWORD1
PTR	KEYWORD1
PVOID	KEYWORD1
PPVOID	KEYWORD1
VOID_P	KEYWORD1
PCVOID	KEYWORD1
PPCVOID	KEYWORD1
bit	KEYWORD1
BIT	KEYWORD1
PBIT	KEYWORD1
RBIT	KEYWORD1
PPBIT	KEYWORD1
BOOL	KEYWORD1
PBOOL	KEYWORD1
RBOOL	KEYWORD1
PPBOOL	KEYWORD1
BOOL_P	KEYWORD1
CBIT	KEYWORD1
PCBIT	KEYWORD1
RCBIT	KEYWORD1
PPCBIT	KEYWORD1
CBOOL	KEYWORD1
PCBOOL	KEYWORD1
RCBOOL	KEYWORD1
PPCBOOL	KEYWORD1
VBIT	KEYWORD1
PVBIT	KEYWORD1
RVBIT	KEYWORD1
PPVBIT	KEYWORD1
VBOOL	KEYWORD1
PVBOOL	KEYWORD1
RVBOOL	KEYWORD1
PPVBOOL	KEYWORD1
int8	KEYWORD1
INT8	KEYWORD1
i8	KEYWORD1
I8	KEYWORD1
CHAR	KEYWORD1
PCHAR	KEYWORD1
RCHAR	KEYWORD1
PPCHAR	KEYWORD1
CHAR_P	KEYWORD1
CCHAR	KEYWORD1
PCCHAR	KEYWORD1
RCCHAR	KEYWORD1
PPCCHAR	KEYWORD1
CSTR_P	KEYWORD1
V8	KEYWORD1
VCHAR	KEYWORD1
PVCHAR	KEYWORD1
RVCHAR	KEYWORD1
PPVCHAR	KEYWORD1
uint8	KEYWORD1
UINT8	KEYWORD1
u8	KEYWORD1
U8	KEYWORD1
BYTE	KEYWORD1
PBYTE	KEYWORD1
RBYTE	KEYWORD1
PPBYTE	KEYWORD1
BYTE_P	KEYWORD1
CBYTE	KEYWORD1
PCBYTE	KEYWORD1
RCBYTE	KEYWORD1
PPCBYTE	KEYWORD1
VU8	KEYWORD1
VBYTE	KEYWORD1
PVBYTE	KEYWORD1
RVBYTE	KEYWORD1
PPVBYTE	KEYWORD1
CVU8	KEYWORD1
CVBYTE	KEYWORD1
PCVBYTE	KEYWORD1
RCVBYTE	KEYWORD1
PPCVBYTE	KEYWORD1
int16	KEYWORD1
INT16	KEYWORD1
i16	KEYWORD1
I16	KEYWORD1
SHORT	KEYWORD1
PSHORT	KEYWORD1
RSHORT	KEYWORD1
PPSHORT	KEYWORD1
SHORT_P	KEYWORD1
CSHORT	KEYWORD1
PCSHORT	KEYWORD1
RCSHORT	KEYWORD1
PPCSHORT	KEYWORD1
V16	KEYWORD1
VSHORT	KEYWORD1
PVSHORT	KEYWORD1
RVSHORT	KEYWORD1
PPVSHORT	KEYWORD1
uint16	KEYWORD1
UINT16	KEYWORD1
u16	KEYWORD1
U16	KEYWORD1
WORD	KEYWORD1
PWORD	KEYWORD1
RWORD	KEYWORD1
PPWORD	KEYWORD1
WORD_P	KEYWORD1
CWORD	KEYWORD1
PCWORD	KEYWORD1
RCWORD	KEYWORD1
PPCWORD	KEYWORD1
VU16	KEYWORD1
VWORD	KEYWORD1
PVWORD	KEYWORD1
RVWORD	KEYWORD1
PPVWORD	KEYWORD1
wchar	KEYWORD1
WCHAR	KEYWORD1
PWCHAR	KEYWORD1
RWCHAR	KEYWORD1
PPWCHAR	KEYWORD1
WCHAR_P	KEYWORD1
CWCHAR	KEYWORD1
PCWCHAR	KEYWORD1
RCWCHAR	KEYWORD1
PPCWCHAR	KEYWORD1
VWCHAR	KEYWORD1
PVWCHAR	KEYWORD1
RVWCHAR	KEYWORD1
PPVWCHAR	KEYWORD1
int32	KEYWORD1
INT32	KEYWORD1
i32	KEYWORD1
I32	KEYWORD1
LONG	KEYWORD1
PLONG	KEYWORD1
RLONG	KEYWORD1
PPLONG	KEYWORD1
LONG_P	KEYWORD1
CLONG	KEYWORD1
PCLONG	KEYWORD1
RCLONG	KEYWORD1
PPCLONG	KEYWORD1
V32	KEYWORD1
VLONG	KEYWORD1
PVLONG	KEYWORD1
RVLONG	KEYWORD1
PPVLONG	KEYWORD1
uint32	KEYWORD1
UINT32	KEYWORD1
u32	KEYWORD1
U32	KEYWORD1
dword	KEYWORD1
DWORD	KEYWORD1
PDWORD	KEYWORD1
RDWORD	KEYWORD1
PPDWORD	KEYWORD1
DWORD_P	KEYWORD1
CDWORD	KEYWORD1
PCDWORD	KEYWORD1
RCDWORD	KEYWORD1
PPCDWORD	KEYWORD1
VU32	KEYWORD1
VDWORD	KEYWORD1
PVDWORD	KEYWORD1
RVDWORD	KEYWORD1
PPVDWORD	KEYWORD1
int64	KEYWORD1
INT64	KEYWORD1
i64	KEYWORD1
I64	KEYWORD1
verylong	KEYWORD1
VERYLONG	KEYWORD1
longlong	KEYWORD1
LONGLONG	KEYWORD1
PLONGLONG	KEYWORD1
RLONGLONG	KEYWORD1
PPLONGLONG	KEYWORD1
LONGLONG_P	KEYWORD1
CLONGLONG	KEYWORD1
PCLONGLONG	KEYWORD1
RCLONGLONG	KEYWORD1
PPCLONGLONG	KEYWORD1
V64	KEYWORD1
VLONGLONG	KEYWORD1
PVLONGLONG	KEYWORD1
RVLONGLONG	KEYWORD1
PPVLONGLONG	KEYWORD1
uint64	KEYWORD1
UINT64	KEYWORD1
u64	KEYWORD1
U64	KEYWORD1
qword	KEYWORD1
QWORD	KEYWORD1
PQWORD	KEYWORD1
RQWORD	KEYWORD1
PPQWORD	KEYWORD1
QWORD_P	KEYWORD1
CQWORD	KEYWORD1
PCQWORD	KEYWORD1
RCQWORD	KEYWORD1
PPCQWORD	KEYWORD1
VU64	KEYWORD1
VQWORD	KEYWORD1
PVQWORD	KEYWORD1
RVQWORD	KEYWORD1
PPVQWORD	KEYWORD1
INT	KEYWORD1
PINT	KEYWORD1
RINT	KEYWORD1
PPINT	KEYWORD1
INT_P	KEYWORD1
CINT	KEYWORD1
PCINT	KEYWORD1
RCINT	KEYWORD1
PPCINT	KEYWORD1
VINT	KEYWORD1
PVINT	KEYWORD1
RVINT	KEYWORD1
PPVINT	KEYWORD1
UINT	KEYWORD1
PUINT	KEYWORD1
RUINT	KEYWORD1
PPUINT	KEYWORD1
UINT_P	KEYWORD1
CUINT	KEYWORD1
PCUINT	KEYWORD1
RCUINT	KEYWORD1
PPCUINT	KEYWORD1
VUINT	KEYWORD1
PVUINT	KEYWORD1
RVUINT	KEYWORD1
PPVUINT	KEYWORD1
FLOAT	KEYWORD1
PFLOAT	KEYWORD1
RFLOAT	KEYWORD1
PPFLOAT	KEYWORD1
FLOAT_P	KEYWORD1
CFLOAT	KEYWORD1
PCFLOAT	KEYWORD1
RCFLOAT	KEYWORD1
PPCFLOAT	KEYWORD1
VFLOAT	KEYWORD1
PVFLOAT	KEYWORD1
RVFLOAT	KEYWORD1
PPVFLOAT	KEYWORD1
DOUBLE	KEYWORD1
PDOUBLE	KEYWORD1
RDOUBLE	KEYWORD1
PPDOUBLE	KEYWORD1
DOUBLE_P	KEYWORD1
CDOUBLE	KEYWORD1
PCDOUBLE	KEYWORD1
RCDOUBLE	KEYWORD1
PPCDOUBLE	KEYWORD1
VDOUBLE	KEYWORD1
PVDOUBLE	KEYWORD1
RVDOUBLE	KEYWORD1
PPVDOUBLE	KEYWORD1
SIZE	KEYWORD1
PSIZE	KEYWORD1
RSIZE	KEYWORD1
PPSIZE	KEYWORD1
SIZE_P	KEYWORD1
CSIZE	KEYWORD1
PCSIZE	KEYWORD1
RCSIZE	KEYWORD1
PPCSIZE	KEYWORD1
PTRDIFF	KEYWORD1
PPTRDIFF	KEYWORD1
RPTRDIFF	KEYWORD1
PPPTRDIFF	KEYWORD1
CPTRDIFF	KEYWORD1
PCPTRDIFF	KEYWORD1
RCPTRDIFF	KEYWORD1
PPCPTRDIFF	KEYWORD1
NULLPTR	KEYWORD1
PNULLPTR	KEYWORD1
RNULLPTR	KEYWORD1
PPNULLPTR	KEYWORD1
CNULLPTR	KEYWORD1
PCNULLPTR	KEYWORD1
RCNULLPTR	KEYWORD1
PPCNULLPTR	KEYWORD1


# type_traits

identity	KEYWORD1
add_const	KEYWORD1
remove_const	KEYWORD1
add_volatile	KEYWORD1
remove_volatile	KEYWORD1
add_cv	KEYWORD1
remove_volatile	KEYWORD1
add_pointer	KEYWORD1
remove_pointer	KEYWORD1
add_rvalue_ref	KEYWORD1
add_reference	KEYWORD1
remove_rvalue_ref	KEYWORD1
remove_reference	KEYWORD1
make_signed	KEYWORD1
make_unsigned	KEYWORD1
enable_if	KEYWORD1
conditional	KEYWORD1
extent	KEYWORD1



# Bits & Bytes

# bits

_BitPack	KEYWORD1
BitPack	KEYWORD1
BITPACK	KEYWORD1
PBITPACK	KEYWORD1
RBITPACK	KEYWORD1
PPBITPACK	KEYWORD1
RRBITPACK	KEYWORD1
CBITPACK	KEYWORD1
PCBITPACK	KEYWORD1
RCBITPACK	KEYWORD1
PPCBITPACK	KEYWORD1


# bytes

_BitProxy	KEYWORD1
_bitproxy_t	KEYWORD1
BitRef	KEYWORD1
BITREF	KEYWORD1
PBITREF	KEYWORD1
RBITREF	KEYWORD1
PPBITREF	KEYWORD1
RRBITREF	KEYWORD1
CBITREF	KEYWORD1
PCBITREF	KEYWORD1
RCBITREF	KEYWORD1
PPCBITREF	KEYWORD1
IByteField	KEYWORD1
IBYTEFIELD	KEYWORD1
PIBYTEFIELD	KEYWORD1
RIBYTEFIELD	KEYWORD1
PPIBYTEFIELD	KEYWORD1
RRIBYTEFIELD	KEYWORD1
CIBYTEFIELD	KEYWORD1
PCIBYTEFIELD	KEYWORD1
RCIBYTEFIELD	KEYWORD1
PPCIBYTEFIELD	KEYWORD1
IWordField	KEYWORD1
IWORDFIELD	KEYWORD1
PIWORDFIELD	KEYWORD1
RIWORDFIELD	KEYWORD1
PPIWORDFIELD	KEYWORD1
RRIWORDFIELD	KEYWORD1
CIWORDFIELD	KEYWORD1
PCIWORDFIELD	KEYWORD1
RCIWORDFIELD	KEYWORD1
PPCIWORDFIELD	KEYWORD1
IDWordField	KEYWORD1
IDWORDFIELD	KEYWORD1
PIDWORDFIELD	KEYWORD1
RIDWORDFIELD	KEYWORD1
PPIDWORDFIELD	KEYWORD1
RRIDWORDFIELD	KEYWORD1
CIDWORDFIELD	KEYWORD1
PCIDWORDFIELD	KEYWORD1
RCIDWORDFIELD	KEYWORD1
PPCIDWORDFIELD	KEYWORD1
ByteField	KEYWORD1
BYTEFIELD	KEYWORD1
PBYTEFIELD	KEYWORD1
RBYTEFIELD	KEYWORD1
PPBYTEFIELD	KEYWORD1
RRBYTEFIELD	KEYWORD1
CBYTEFIELD	KEYWORD1
PCBYTEFIELD	KEYWORD1
RCBYTEFIELD	KEYWORD1
PPCBYTEFIELD	KEYWORD1
WordField	KEYWORD1
WORDFIELD	KEYWORD1
PWORDFIELD	KEYWORD1
RWORDFIELD	KEYWORD1
PPWORDFIELD	KEYWORD1
RRWORDFIELD	KEYWORD1
CWORDFIELD	KEYWORD1
PCWORDFIELD	KEYWORD1
RCWORDFIELD	KEYWORD1
PPCWORDFIELD	KEYWORD1
DWordField	KEYWORD1
DWORDFIELD	KEYWORD1
PDWORDFIELD	KEYWORD1
RDWORDFIELD	KEYWORD1
PPDWORDFIELD	KEYWORD1
RRDWORDFIELD	KEYWORD1
CDWORDFIELD	KEYWORD1
PCDWORDFIELD	KEYWORD1
RCDWORDFIELD	KEYWORD1
PPCDWORDFIELD	KEYWORD1
IBitField	KEYWORD1
IBITFIELD	KEYWORD1
PIBITFIELD	KEYWORD1
RIBITFIELD	KEYWORD1
PPIBITFIELD	KEYWORD1
RRIBITFIELD	KEYWORD1
CIBITFIELD	KEYWORD1
PCIBITFIELD	KEYWORD1
RCIBITFIELD	KEYWORD1
PPCIBITFIELD	KEYWORD1
IManyBitField	KEYWORD1
IMANYBITFIELD	KEYWORD1
PIMANYBITFIELD	KEYWORD1
RIMANYBITFIELD	KEYWORD1
PPIMANYBITFIELD	KEYWORD1
RRIMANYBITFIELD	KEYWORD1
CIMANYBITFIELD	KEYWORD1
PCIMANYBITFIELD	KEYWORD1
RCIMANYBITFIELD	KEYWORD1
PPCIMANYBITFIELD	KEYWORD1
BitField	KEYWORD1
BITFIELD	KEYWORD1
PBITFIELD	KEYWORD1
RBITFIELD	KEYWORD1
PPBITFIELD	KEYWORD1
RRBITFIELD	KEYWORD1
CBITFIELD	KEYWORD1
PCBITFIELD	KEYWORD1
RCBITFIELD	KEYWORD1
PPCBITFIELD	KEYWORD1
ManyBitField	KEYWORD1
MANYBITFIELD	KEYWORD1
PMANYBITFIELD	KEYWORD1
RMANYBITFIELD	KEYWORD1
PPMANYBITFIELD	KEYWORD1
RRMANYBITFIELD	KEYWORD1
CMANYBITFIELD	KEYWORD1
PCMANYBITFIELD	KEYWORD1
RCMANYBITFIELD	KEYWORD1
PPCMANYBITFIELD	KEYWORD1


# registers

REG8	KEYWORD1
PREG8	KEYWORD1
RREG8	KEYWORD1
PPREG8	KEYWORD1
RRREG8	KEYWORD1
REG16	KEYWORD1
PREG16	KEYWORD1
RREG16	KEYWORD1
PPREG16	KEYWORD1
RRREG16	KEYWORD1
REG32	KEYWORD1
PREG32	KEYWORD1
RREG32	KEYWORD1
PPREG32	KEYWORD1
RRREG32	KEYWORD1


# IO

# GPIO

PIN_NUMBER	KEYWORD1

_PortRegisters	KEYWORD1
_portregisters_t	KEYWORD1
PortReg	KEYWORD1
PORTREG	KEYWORD1
PPORTREG	KEYWORD1
RPORTREG	KEYWORD1
PPPORTREG	KEYWORD1
RRPORTREG	KEYWORD1
CPORTREG	KEYWORD1
PCPORTREG	KEYWORD1
RCPORTREG	KEYWORD1
PPCPORTREG	KEYWORD1
_Port	KEYWORD1
_port_t	KEYWORD1
Port	KEYWORD1
PORT	KEYWORD1
PPORT	KEYWORD1
RPORT	KEYWORD1
PPPORT	KEYWORD1
RRPORT	KEYWORD1
CPORT	KEYWORD1
PCPORT	KEYWORD1
RCPORT	KEYWORD1
PPCPORT	KEYWORD1
_GPIO	KEYWORD1
_GPIO_t	KEYWORD1
GPIO	KEYWORD1
PGPIO	KEYWORD1
RGPIO	KEYWORD1
PPGPIO	KEYWORD1
RRGPIO	KEYWORD1
CGPIO	KEYWORD1
PCGPIO	KEYWORD1
RCGPIO	KEYWORD1
PPCGPIO	KEYWORD1
_Pin	KEYWORD1
_pin_t	KEYWORD1
Pin	KEYWORD1
PIN	KEYWORD1

GPIO	KEYWORD1


# Control




# Data

# values

ConstValue	KEYWORD1
CONSTVALUE	KEYWORD1
PCONSTVALUE	KEYWORD1
RCONSTVALUE	KEYWORD1
PPCONSTVALUE	KEYWORD1
RRCONSTVALUE	KEYWORD1
CCONSTVALUE	KEYWORD1
PCCONSTVALUE	KEYWORD1
RCCONSTVALUE	KEYWORD1
PPCCONSTVALUE	KEYWORD1
Value	KEYWORD1
VALUE	KEYWORD1
PVALUE	KEYWORD1
RVALUE	KEYWORD1
PPVALUE	KEYWORD1
RRVALUE	KEYWORD1
CVALUE	KEYWORD1
PCVALUE	KEYWORD1
RCVALUE	KEYWORD1
PPCVALUE	KEYWORD1


# datum

ISerializable	KEYWORD1
ISERIALIZABLE	KEYWORD1
PISERIALIZABLE	KEYWORD1
RISERIALIZABLE	KEYWORD1
PPISERIALIZABLE	KEYWORD1
RRISERIALIZABLE	KEYWORD1
CISERIALIZABLE	KEYWORD1
PCISERIALIZABLE	KEYWORD1
RCISERIALIZABLE	KEYWORD1
PPCISERIALIZABLE	KEYWORD1
ITransmittable	KEYWORD1
ITRANSMITTABLE	KEYWORD1
PITRANSMITTABLE	KEYWORD1
RITRANSMITTABLE	KEYWORD1
PPITRANSMITTABLE	KEYWORD1
RRITRANSMITTABLE	KEYWORD1
CITRANSMITTABLE	KEYWORD1
PCITRANSMITTABLE	KEYWORD1
RCITRANSMITTABLE	KEYWORD1
PPCITRANSMITTABLE	KEYWORD1
IDatum	KEYWORD1
IDATUM	KEYWORD1
PIDATUM	KEYWORD1
RIDATUM	KEYWORD1
PPIDATUM	KEYWORD1
RRIDATUM	KEYWORD1
CIDATUM	KEYWORD1
PCIDATUM	KEYWORD1
RCIDATUM	KEYWORD1
PPCIDATUM	KEYWORD1
DatumBase	KEYWORD1
DATUMBASE	KEYWORD1
PDATUMBASE	KEYWORD1
RDATUMBASE	KEYWORD1
PPDATUMBASE	KEYWORD1
RRDATUMBASE	KEYWORD1
CDATUMBASE	KEYWORD1
PCDATUMBASE	KEYWORD1
RCDATUMBASE	KEYWORD1
PPCDATUMBASE	KEYWORD1


# params

IParam	KEYWORD1
IPARAM	KEYWORD1
PIPARAM	KEYWORD1
RIPARAM	KEYWORD1
PPIPARAM	KEYWORD1
RRIPARAM	KEYWORD1
CIPARAM	KEYWORD1
PCIPARAM	KEYWORD1
RCIPARAM	KEYWORD1
PPCIPARAM	KEYWORD1
ParamBase	KEYWORD1
PARAMBASE	KEYWORD1
PPARAMBASE	KEYWORD1
RPARAMBASE	KEYWORD1
PPPARAMBASE	KEYWORD1
RRPARAMBASE	KEYWORD1
CPARAMBASE	KEYWORD1
PCPARAMBASE	KEYWORD1
RCPARAMBASE	KEYWORD1
PPCPARAMBASE	KEYWORD1
Param	KEYWORD1
PARAM	KEYWORD1
PPARAM	KEYWORD1
RPARAM	KEYWORD1
PPPARAM	KEYWORD1
RRPARAM	KEYWORD1
CPARAM	KEYWORD1
PCPARAM	KEYWORD1
RCPARAM	KEYWORD1
PPCPARAM	KEYWORD1
VarLengthParam	KEYWORD1
VARLENGTHPARAM	KEYWORD1
PVARLENGTHPARAM	KEYWORD1
RVARLENGTHPARAM	KEYWORD1
PPVARLENGTHPARAM	KEYWORD1
RRVARLENGTHPARAM	KEYWORD1
CVARLENGTHPARAM	KEYWORD1
PCVARLENGTHPARAM	KEYWORD1
RCVARLENGTHPARAM	KEYWORD1
PPCVARLENGTHPARAM	KEYWORD1
TypedParam	KEYWORD1
TYPEDPARAM	KEYWORD1
PTYPEDPARAM	KEYWORD1
RTYPEDPARAM	KEYWORD1
PPTYPEDPARAM	KEYWORD1
RRTYPEDPARAM	KEYWORD1
CTYPEDPARAM	KEYWORD1
PCTYPEDPARAM	KEYWORD1
RCTYPEDPARAM	KEYWORD1
PPCTYPEDPARAM	KEYWORD1
VarLengthTypedParam	KEYWORD1
VARLENGTHTYPEDPARAM	KEYWORD1
PVARLENGTHTYPEDPARAM	KEYWORD1
RVARLENGTHTYPEDPARAM	KEYWORD1
PPVARLENGTHTYPEDPARAM	KEYWORD1
RRVARLENGTHTYPEDPARAM	KEYWORD1
CVARLENGTHTYPEDPARAM	KEYWORD1
PCVARLENGTHTYPEDPARAM	KEYWORD1
RCVARLENGTHTYPEDPARAM	KEYWORD1
PPCVARLENGTHTYPEDPARAM	KEYWORD1


# fields

IField	KEYWORD1
IFIELD	KEYWORD1
PIFIELD	KEYWORD1
RIFIELD	KEYWORD1
PPIFIELD	KEYWORD1
RRIFIELD	KEYWORD1
CIFIELD	KEYWORD1
PCIFIELD	KEYWORD1
RCIFIELD	KEYWORD1
PPCIFIELD	KEYWORD1
FieldBase	KEYWORD1
FIELDBASE	KEYWORD1
PFIELDBASE	KEYWORD1
RFIELDBASE	KEYWORD1
PPFIELDBASE	KEYWORD1
RRFIELDBASE	KEYWORD1
CFIELDBASE	KEYWORD1
PCFIELDBASE	KEYWORD1
RCFIELDBASE	KEYWORD1
PPCFIELDBASE	KEYWORD1
Field	KEYWORD1
FIELD	KEYWORD1
PFIELD	KEYWORD1
RFIELD	KEYWORD1
PPFIELD	KEYWORD1
RRFIELD	KEYWORD1
CFIELD	KEYWORD1
PCFIELD	KEYWORD1
RCFIELD	KEYWORD1
PPCFIELD	KEYWORD1
VarLengthField	KEYWORD1
VARLENGTHFIELD	KEYWORD1
PVARLENGTHFIELD	KEYWORD1
RVARLENGTHFIELD	KEYWORD1
PPVARLENGTHFIELD	KEYWORD1
RRVARLENGTHFIELD	KEYWORD1
CVARLENGTHFIELD	KEYWORD1
PCVARLENGTHFIELD	KEYWORD1
RCVARLENGTHFIELD	KEYWORD1
PPCVARLENGTHFIELD	KEYWORD1
TypedField	KEYWORD1
TYPEDFIELD	KEYWORD1
PTYPEDFIELD	KEYWORD1
RTYPEDFIELD	KEYWORD1
PPTYPEDFIELD	KEYWORD1
RRTYPEDFIELD	KEYWORD1
CTYPEDFIELD	KEYWORD1
PCTYPEDFIELD	KEYWORD1
RCTYPEDFIELD	KEYWORD1
PPCTYPEDFIELD	KEYWORD1
VarLengthTypedField	KEYWORD1
VARLENGTHTYPEDFIELD	KEYWORD1
PVARLENGTHTYPEDFIELD	KEYWORD1
RVARLENGTHTYPEDFIELD	KEYWORD1
PPVARLENGTHTYPEDFIELD	KEYWORD1
RRVARLENGTHTYPEDFIELD	KEYWORD1
CVARLENGTHTYPEDFIELD	KEYWORD1
PCVARLENGTHTYPEDFIELD	KEYWORD1
RCVARLENGTHTYPEDFIELD	KEYWORD1
PPCVARLENGTHTYPEDFIELD	KEYWORD1


# Communication


# messages

IMessage	KEYWORD1
IMESSAGE	KEYWORD1
PIMESSAGE	KEYWORD1
RIMESSAGE	KEYWORD1
PPIMESSAGE	KEYWORD1
RRIMESSAGE	KEYWORD1
CIMESSAGE	KEYWORD1
PCIMESSAGE	KEYWORD1
RCIMESSAGE	KEYWORD1
PPCIMESSAGE	KEYWORD1
Message	KEYWORD1
MESSAGE	KEYWORD1
PMESSAGE	KEYWORD1
RMESSAGE	KEYWORD1
PPMESSAGE	KEYWORD1
RRMESSAGE	KEYWORD1
CMESSAGE	KEYWORD1
PCMESSAGE	KEYWORD1
RCMESSAGE	KEYWORD1
PPCMESSAGE	KEYWORD1
GenericMessage	KEYWORD1
GENERICMESSAGE	KEYWORD1
PGENERICMESSAGE	KEYWORD1
RGENERICMESSAGE	KEYWORD1
PPGENERICMESSAGE	KEYWORD1
RRGENERICMESSAGE	KEYWORD1
CGENERICMESSAGE	KEYWORD1
PCGENERICMESSAGE	KEYWORD1
RCGENERICMESSAGE	KEYWORD1
PPCGENERICMESSAGE	KEYWORD1


# Storage

# storage

StorageLocation	KEYWORD1
STORAGELOCATION	KEYWORD1
PSTORAGELOCATION	KEYWORD1
RSTORAGELOCATION	KEYWORD1
PPSTORAGELOCATION	KEYWORD1
RRSTORAGELOCATION	KEYWORD1
CSTORAGELOCATION	KEYWORD1
PCSTORAGELOCATION	KEYWORD1
RCSTORAGELOCATION	KEYWORD1
PPCSTORAGELOCATION	KEYWORD1
IStorage	KEYWORD1
ISTORAGE	KEYWORD1
PISTORAGE	KEYWORD1
RISTORAGE	KEYWORD1
PPISTORAGE	KEYWORD1
RRISTORAGE	KEYWORD1
CISTORAGE	KEYWORD1
PCISTORAGE	KEYWORD1
RCISTORAGE	KEYWORD1
PPCISTORAGE	KEYWORD1
StorageBase	KEYWORD1
STORAGEBASE	KEYWORD1
PSTORAGEBASE	KEYWORD1
RSTORAGEBASE	KEYWORD1
PPSTORAGEBASE	KEYWORD1
RRSTORAGEBASE	KEYWORD1
CSTORAGEBASE	KEYWORD1
PCSTORAGEBASE	KEYWORD1
RCSTORAGEBASE	KEYWORD1
PPCSTORAGEBASE	KEYWORD1


# storage_adapters

StorageAdapter	KEYWORD1
STORAGEADAPTER	KEYWORD1
PSTORAGEADAPTER	KEYWORD1
RSTORAGEADAPTER	KEYWORD1
PPSTORAGEADAPTER	KEYWORD1
RRSTORAGEADAPTER	KEYWORD1
CSTORAGEADAPTER	KEYWORD1
PCSTORAGEADAPTER	KEYWORD1
RCSTORAGEADAPTER	KEYWORD1
PPCSTORAGEADAPTER	KEYWORD1


# EEPROM_I2C

_EEEPtr	KEYWORD1
EEEPtr	KEYWORD1
EEEPTR	KEYWORD1
PEEEPtr	KEYWORD1
REEEPtr	KEYWORD1
PPEEEPtr	KEYWORD1
RREEEPtr	KEYWORD1
CEEEPtr	KEYWORD1
PCEEEPtr	KEYWORD1
RCEEEPtr	KEYWORD1
PPCEEEPtr	KEYWORD1
_EEERef	KEYWORD1
EEERef	KEYWORD1
EEEREF	KEYWORD1
PEEEREF	KEYWORD1
REEEREF	KEYWORD1
PPEEEREF	KEYWORD1
RREEEREF	KEYWORD1
CEEEREF	KEYWORD1
PCEEEREF	KEYWORD1
RCEEEREF	KEYWORD1
PPCEEEREF	KEYWORD1
EEPROM_I2C	KEYWORD1
EEPROMI2C	KEYWORD1
PEEPROMI2C	KEYWORD1
REEPROMI2C	KEYWORD1
PPEEPROMI2C	KEYWORD1
RREEPROMI2C	KEYWORD1
CEEPROMI2C	KEYWORD1
PCEEPROMI2C	KEYWORD1
RCEEPROMI2C	KEYWORD1
PPCEEPROMI2C	KEYWORD1



# Database




#######################################
# Macros, Functions, Members (KEYWORD2)
#######################################

# Types

# aliases

EXTERN	KEYWORD2
INLINE	KEYWORD2
EXPLICIT	KEYWORD2
STATIC	KEYWORD2
FINAL	KEYWORD2
VIRTUAL	KEYWORD2
CONSTEXPR	KEYWORD2
CONST	KEYWORD2
CONSTREF	KEYWORD2
CONSTPTR	KEYWORD2
VOLATILE	KEYWORD2
CONST_VOLATILE	KEYWORD2
cv	KEYWORD2
CV	KEYWORD2
ENUM	KEYWORD2
UNION	KEYWORD2
STRUCT	KEYWORD2
CLASS	KEYWORD2
INTERFACE	KEYWORD2
TEMPLATE	KEYWORD2
TEMPLATE_STRUCT	KEYWORD2
TEMPLATE_CLASS	KEYWORD2
TEMPLATE_INTERFACE	KEYWORD2
SIGNED	KEYWORD2
SIGNED_BYTE	KEYWORD2
SIGNED_WORD	KEYWORD2
SIGNED_LONG	KEYWORD2
SIGNED_QWORD	KEYWORD2
UNSIGNED	KEYWORD2
UNSIGNED_CHAR	KEYWORD2
UNSIGNED_SHORT	KEYWORD2
UNSIGNED_LONG	KEYWORD2
UNSIGNED_LONGLONG	KEYWORD2


# util

NULL_MACRO	KEYWORD2
EXPAND	KEYWORD2
STR	KEYWORD2
EXPAND_STR	KEYWORD2
CONCAT	KEYWORD2
EXPAND_CONCAT	KEYWORD2
__VA_MACRO	KEYWORD2
_VA_MACRO	KEYWORD2
VA_MACRO	KEYWORD2
ALWAYS_INLINE	KEYWORD2
PACKED	KEYWORD2
PACKED_UNION	KEYWORD2
PACKED_STRUCT	KEYWORD2
BITFIELD_STRUCT	KEYWORD2
TYPEOF	KEYWORD2
SIZEOF	KEYWORD2
countof	KEYWORD2
COUNT	KEYWORD2
IDENTITY	KEYWORD2
CONST_TYPE	KEYWORD2
CONST_TYPEOF	KEYWORD2
UNCONST_TYPE	KEYWORD2
UNCONST_TYPEOF	KEYWORD2
VOLATILE_TYPE	KEYWORD2
UNVOLATILE_TYPE	KEYWORD2
CV_TYPE	KEYWORD2
CV_TYPEOF	KEYWORD2
UNCV_TYPE	KEYWORD2
UNCV_TYPEOF	KEYWORD2
ONLY_CONST_TYPE	KEYWORD2
ONLY_CONST_TYPEOF	KEYWORD2
ONLY_VOLATILE_TYPE	KEYWORD2
ONLY_VOLATILE_TYPEOF	KEYWORD2
POINTER_TYPE	KEYWORD2
ONLY_VOLATILE_TYPEOF	KEYWORD2
UNPOINTER_TYPE	KEYWORD2
UNPOINTER_TYPEOF	KEYWORD2
RVALUE_TYPE	KEYWORD2
RVALUE_TYPEOF	KEYWORD2
UNRVALUE_TYPE	KEYWORD2
UNRVALUE_TYPEOF	KEYWORD2
REFERENCE_TYPE	KEYWORD2
REFERENCE_TYPEOF	KEYWORD2
UNREFERENCE_TYPE	KEYWORD2
UNREFERENCE_TYPEOF	KEYWORD2
SIGNED_TYPE	KEYWORD2
SIGNED_TYPEOF	KEYWORD2
UNSIGNED_TYPE	KEYWORD2
UNSIGNED_TYPEOF	KEYWORD2
MAKE_SIGNED	KEYWORD2
MAKE_UNSIGNED	KEYWORD2
ENABLE_IF	KEYWORD2
TYPE_IF	KEYWORD2
CAPACITY	KEYWORD2
BYTE_SIZE	KEYWORD2
BYTE_SIZEOF	KEYWORD2
BIT_SIZE	KEYWORD2
BIT_SIZEOF	KEYWORD2
MAKE_CONST	KEYWORD2
MAKE_CONST_2D	KEYWORD2
MAKE_CONST_PP	KEYWORD2
FORCE_CONST	KEYWORD2
UNCONST	KEYWORD2
UNION_CAST	KEYWORD2
F	KEYWORD2
FLASH_STRING	KEYWORD2
_CSTR_P	KEYWORD2
FLASH_FUNCTION_VARIATION	KEYWORD2
PASS_FLASH_STRING	KEYWORD2
ASM	KEYWORD2
NOP	KEYWORD2
COMPILER_BARRIER	KEYWORD2
MEMORY_BARRIER	KEYWORD2
BARRIER	KEYWORD2
PREFETCH	KEYWORD2
PREFETCH_1	KEYWORD2
PREFETCH_2	KEYWORD2
PREFETCH_3	KEYWORD2
EXPECT	KEYWORD2
EXPECTED	KEYWORD2
NOT_EXPECTED	KEYWORD2
PRAGMA_MACRO	KEYWORD2
IGNORE_WARNING	KEYWORD2
CODE_FILE_NAME	KEYWORD2
CODE_FUNCTION_NAME	KEYWORD2
CODE_LINE_NUMBER	KEYWORD2
CODE_FILE_NAME_P	KEYWORD2
CODE_FUNCTION_NAME_P	KEYWORD2
CODE_LINE_NUMBER_P	KEYWORD2
VAR_NAME_VALUE	KEYWORD2
PRINT_VAR	KEYWORD2
PRINT_COMPILE_CONST	KEYWORD2
ever	KEYWORD2
forever	KEYWORD2
T_SIZE	KEYWORD2
MAX_T	KEYWORD2
FORCE_ANONYMOUS_CONSTRUCTION	KEYWORD2
_CONSTRUCT	KEYWORD2
SOFT_RESET	KEYWORD2
overflow	KEYWORD2
Apply	KEYWORD2


# Info

__data_start	KEYWORD2
__data_end	KEYWORD2
__bss_start	KEYWORD2
__bss_end	KEYWORD2
__heap_start	KEYWORD2
__heap_end	KEYWORD2
__brkval	KEYWORD2
_etext	KEYWORD2
_edata	KEYWORD2
__malloc_heap_start	KEYWORD2
__malloc_heap_end	KEYWORD2
__malloc_margin	KEYWORD2

CPUType	KEYWORD2
FreeRam	KEYWORD2
StackPointer	KEYWORD2
StackSpaceTotal	KEYWORD2
StackSpaceUsed	KEYWORD2
StackSpaceAvailable	KEYWORD2
HeapPointer	KEYWORD2
HeapSpaceTotal	KEYWORD2
HeapSpaceUsed	KEYWORD2
HeapSpaceAvailable	KEYWORD2
SRAMTotalSize	KEYWORD2
SRAMUsed	KEYWORD2
SRAMAvailable	KEYWORD2
XRAMTotalSize	KEYWORD2
XRAMUsed	KEYWORD2
XRAMAvailable	KEYWORD2
TotalRAMUsed	KEYWORD2
TotalRAMAvailable	KEYWORD2
TotalRAMUsed	KEYWORD2
TotalRAMAvailable	KEYWORD2
TotalRAMSize	KEYWORD2
ROMUsed	KEYWORD2
EEPROMTotalSize	KEYWORD2
EEPROMUsed	KEYWORD2
EEPROMAvailable	KEYWORD2
FlashROMTotalSize	KEYWORD2
BootloaderAllocatedSize	KEYWORD2
BootloaderSize	KEYWORD2
SketchSpaceTotalSize	KEYWORD2
SketchSpaceUsed	KEYWORD2
SketchSize	KEYWORD2
SketchSpaceAvailable	KEYWORD2
FlashROMUsed	KEYWORD2
FlashROMAvailable	KEYWORD2
ProgMemTotalSize	KEYWORD2
ProgMemUsed	KEYWORD2
ProgMemAvailable	KEYWORD2



# Bits & Bytes

# bits

REDUNDANT_LEADING_BITS_16	KEYWORD2
REDUNDANT_LEADING_BITS_32	KEYWORD2
REDUNDANT_LEADING_BITS_64	KEYWORD2
REDUNDANT_LEADING_BITS	KEYWORD2
LEAST_SIGNIFICANT_ONE_BIT_16	KEYWORD2
LEAST_SIGNIFICANT_ONE_BIT_32	KEYWORD2
LEAST_SIGNIFICANT_ONE_BIT_64	KEYWORD2
LEAST_SIGNIFICANT_ONE_BIT	KEYWORD2
ONE_BITS_16	KEYWORD2
ONE_BITS_32	KEYWORD2
ONE_BITS_64	KEYWORD2
ONE_BITS	KEYWORD2
LEADING_ZERO_BITS_16	KEYWORD2
LEADING_ZERO_BITS_32	KEYWORD2
LEADING_ZERO_BITS_64	KEYWORD2
LEADING_ZERO_BITS	KEYWORD2
TRAILING_ZERO_BITS_16	KEYWORD2
TRAILING_ZERO_BITS_32	KEYWORD2
TRAILING_ZERO_BITS_64	KEYWORD2
TRAILING_ZERO_BITS	KEYWORD2
BIT_PARITY_16	KEYWORD2
BIT_PARITY_32	KEYWORD2
BIT_PARITY_64	KEYWORD2
BIT_PARITY	KEYWORD2
NOT	KEYWORD2
AND	KEYWORD2
NAND	KEYWORD2
OR	KEYWORD2
NOR	KEYWORD2
XOR	KEYWORD2
SHIFT_RIGHT	KEYWORD2
SHR	KEYWORD2
SHIFT_LEFT	KEYWORD2
SHL	KEYWORD2
MASK	KEYWORD2
INVERSE_MASK	KEYWORD2
BIT_MASK	KEYWORD2
BMASK	KEYWORD2
NOT_BIT	KEYWORD2
NYBBLE_MASK	KEYWORD2
NOT_NYBBLE	KEYWORD2
BYTE_MASK	KEYWORD2
NOT_BYTE	KEYWORD2
WORD_MASK	KEYWORD2
NOT_WORD	KEYWORD2
DWORD_MASK	KEYWORD2
NOT_DWORD	KEYWORD2
BMASKNOT	KEYWORD2
NOT_BITS	KEYWORD2
BITS	KEYWORD2
CHECK_BITS	KEYWORD2
CHECK_BITS_SET	KEYWORD2
BMASKSNT	KEYWORD2
CHECK_BITS_SNT	KEYWORD2
CHECK_BITS_UNSET	KEYWORD2
BMASKSET	KEYWORD2
SET_BITS	KEYWORD2
BMASKRST	KEYWORD2
RESET_BITS	KEYWORD2
UNSET_BITS	KEYWORD2
CLEAR_BITS	KEYWORD2
BMASKFLP	KEYWORD2
FLIP_BITS	KEYWORD2
TOGGLE_BITS	KEYWORD2
SET_BITS_FROM	KEYWORD2
CLEAR_BITS_FROM	KEYWORD2
COPY_BITS	KEYWORD2
BMASKNOTP	KEYWORD2
NOT_BITS_PAIR	KEYWORD2
BMASKP	KEYWORD2
BITS_PAIR	KEYWORD2
MASK_PAIR	KEYWORD2
CHECK_BITS_PAIR	KEYWORD2
CHECK_BITS_SET_PAIR	KEYWORD2
BMASKSNTP	KEYWORD2
CHECK_BITS_SNT_PAIR	KEYWORD2
CHECK_BITS_UNSET_PAIR	KEYWORD2
BMASKSETP	KEYWORD2
SET_BITS_PAIR	KEYWORD2
BMASKRSTP	KEYWORD2
RESET_BITS_PAIR	KEYWORD2
UNSET_BITS_PAIR	KEYWORD2
CLEAR_BITS_PAIR	KEYWORD2
BMASKFLPP	KEYWORD2
FLIP_BITS_PAIR	KEYWORD2
TOGGLE_BITS_PAIR	KEYWORD2
SET_BITS_FROM_PAIR	KEYWORD2
CLEAR_BITS_FROM_PAIR	KEYWORD2
COPY_BITS_PAIR	KEYWORD2
SET_BITS_FROM_TUPLE	KEYWORD2
CLEAR_BITS_FROM_TUPLE	KEYWORD2
COPY_BITS_TUPLE	KEYWORD2
BNOT	KEYWORD2
BCHK	KEYWORD2
CHECK_BIT	KEYWORD2
CHECK_SET	KEYWORD2
BSNT	KEYWORD2
CHECK_BIT_NOT	KEYWORD2
CHECK_UNSET	KEYWORD2
BSET	KEYWORD2
SET_BIT	KEYWORD2
BRST	KEYWORD2
RESET_BIT	KEYWORD2
UNSET_BIT	KEYWORD2
CLEAR_BIT	KEYWORD2
BFLP	KEYWORD2
FLIP_BIT	KEYWORD2
TOGGLE_BIT	KEYWORD2
NOW_FLIP_BIT	KEYWORD2
FLIP_BIT_GOOD	KEYWORD2
SET_BIT_TO	KEYWORD2
SET_BIT_FROM	KEYWORD2
CLEAR_BIT_FROM	KEYWORD2
COPY_BIT	KEYWORD2
BNOTP	KEYWORD2
NOT_BIT_PAIR	KEYWORD2
BCHKP	KEYWORD2
CHECK_BIT_PAIR	KEYWORD2
CHECK_SET_PAIR	KEYWORD2
BSNTP	KEYWORD2
CHECK_BIT_NOT_PAIR	KEYWORD2
CHECK_UNSET_PAIR	KEYWORD2
BSETP	KEYWORD2
SET_BIT_PAIR	KEYWORD2
BRSTP	KEYWORD2
UNSET_BIT_PAIR	KEYWORD2
RESET_BIT_PAIR	KEYWORD2
CLEAR_BIT_PAIR	KEYWORD2
BFLPP	KEYWORD2
FLIP_BIT_PAIR	KEYWORD2
TOGGLE_BIT_PAIR	KEYWORD2
SET_BIT_TO_PAIR	KEYWORD2
SET_BIT_FROM_PAIR	KEYWORD2
CLEAR_BIT_FROM_PAIR	KEYWORD2
COPY_BIT_PAIR	KEYWORD2
SET_BIT_TO_TUPLE	KEYWORD2
SET_BIT_FROM_TUPLE	KEYWORD2
CLEAR_BIT_FROM_TUPLE	KEYWORD2
COPY_BIT_TUPLE	KEYWORD2
BIT0_MASK	KEYWORD2
CHECK_BIT0	KEYWORD2
CHECK_UNSET_BIT0	KEYWORD2
SET_BIT0	KEYWORD2
CLEAR_BIT0	KEYWORD2
TOGGLE_BIT0	KEYWORD2
BIT1_MASK	KEYWORD2
CHECK_BIT1	KEYWORD2
CHECK_UNSET_BIT1	KEYWORD2
SET_BIT1	KEYWORD2
CLEAR_BIT1	KEYWORD2
TOGGLE_BIT1	KEYWORD2
BIT2_MASK	KEYWORD2
CHECK_BIT2	KEYWORD2
CHECK_UNSET_BIT2	KEYWORD2
SET_BIT2	KEYWORD2
CLEAR_BIT2	KEYWORD2
TOGGLE_BIT2	KEYWORD2
BIT3_MASK	KEYWORD2
CHECK_BIT3	KEYWORD2
CHECK_UNSET_BIT3	KEYWORD2
SET_BIT3	KEYWORD2
CLEAR_BIT3	KEYWORD2
TOGGLE_BIT3	KEYWORD2
BIT4_MASK	KEYWORD2
CHECK_BIT4	KEYWORD2
CHECK_UNSET_BIT4	KEYWORD2
SET_BIT4	KEYWORD2
CLEAR_BIT4	KEYWORD2
TOGGLE_BIT4	KEYWORD2
BIT5_MASK	KEYWORD2
CHECK_BIT5	KEYWORD2
CHECK_UNSET_BIT5	KEYWORD2
SET_BIT5	KEYWORD2
CLEAR_BIT5	KEYWORD2
TOGGLE_BIT5	KEYWORD2
BIT6_MASK	KEYWORD2
CHECK_BIT6	KEYWORD2
CHECK_UNSET_BIT6	KEYWORD2
SET_BIT6	KEYWORD2
CLEAR_BIT6	KEYWORD2
TOGGLE_BIT6	KEYWORD2
BIT7_MASK	KEYWORD2
CHECK_BIT7	KEYWORD2
CHECK_UNSET_BIT7	KEYWORD2
SET_BIT7	KEYWORD2
CLEAR_BIT7	KEYWORD2
TOGGLE_BIT7	KEYWORD2
LOW_NYBBLE_MASK	KEYWORD2
HIGH_NYBBLE_MASK	KEYWORD2
LOW_NYBBLE	KEYWORD2
HIGH_NYBBLE	KEYWORD2
CHECK_NYBBLE	KEYWORD2
CHECK_UNSET_NYBBLE	KEYWORD2
SET_LOW_NYBBLE	KEYWORD2
SET_HIGH_NYBBLE	KEYWORD2
CLEAR_LOW_NYBBLE	KEYWORD2
CLEAR_HIGH_NYBBLE	KEYWORD2
TOGGLE_LOW_NYBBLE	KEYWORD2
TOGGLE_HIGH_NYBBLE	KEYWORD2
SET_NYBBLE	KEYWORD2
CLEAR_NYBBLE	KEYWORD2
COPY_NYBBLE	KEYWORD2
LOW_BYTE_MASK	KEYWORD2
HIGH_BYTE_MASK	KEYWORD2
LOW_BYTE	KEYWORD2
HIGH_BYTE	KEYWORD2
CHECK_BYTE	KEYWORD2
CHECK_UNSET_BYTE	KEYWORD2
SET_LOW_BYTE	KEYWORD2
SET_HIGH_BYTE	KEYWORD2
CLEAR_LOW_BYTE	KEYWORD2
CLEAR_HIGH_BYTE	KEYWORD2
TOGGLE_LOW_BYTE	KEYWORD2
TOGGLE_HIGH_BYTE	KEYWORD2
SET_BYTE	KEYWORD2
CLEAR_BYTE	KEYWORD2
COPY_BYTE	KEYWORD2
LOW_WORD_MASK	KEYWORD2
HIGH_WORD_MASK	KEYWORD2
LOW_WORD	KEYWORD2
HIGH_WORD	KEYWORD2
CHECK_WORD	KEYWORD2
CHECK_UNSET_WORD	KEYWORD2
SET_LOW_WORD	KEYWORD2
SET_HIGH_WORD	KEYWORD2
CLEAR_LOW_WORD	KEYWORD2
CLEAR_HIGH_WORD	KEYWORD2
TOGGLE_LOW_WORD	KEYWORD2
TOGGLE_HIGH_WORD	KEYWORD2
SET_WORD	KEYWORD2
CLEAR_WORD	KEYWORD2
COPY_WORD	KEYWORD2
PACK_BYTE	KEYWORD2
PACK_BYTE_REF	KEYWORD2
PACK_BYTE_CREF	KEYWORD2
PACK_BYTE_VAL	KEYWORD2
_B	KEYWORD2
BIT0	KEYWORD2
BIT1	KEYWORD2
BIT2	KEYWORD2
BIT3	KEYWORD2
BIT4	KEYWORD2
BIT5	KEYWORD2
BIT6	KEYWORD2
BIT7	KEYWORD2


#bytes

LITTLE_ENDIAN	KEYWORD2
BIG_ENDIAN	KEYWORD2
NETWORK_ORDER	KEYWORD2
ENDIANNESS	KEYWORD2
IS_LITTLE_ENDIAN	KEYWORD2
IS_BIG_ENDIAN	KEYWORD2
REVERSE_ENDIANNESS_16	KEYWORD2
REVERSE_ENDIANNESS_32	KEYWORD2
REVERSE_ENDIANNESS_64	KEYWORD2
REVERSE_ENDIANNESS	KEYWORD2


# registers

REGISTER	KEYWORD2
REG_VAR	KEYWORD2
REG_CHAR	KEYWORD2
REG_BYTE	KEYWORD2
NEW_REG8	KEYWORD2



# IO

# GPIO

PinMode	KEYWORD2


# GPIO_arduino

ARDUINO_PORT_TO_MODE	KEYWORD2
ARDUINO_PORT_TO_OUTPUT	KEYWORD2
ARDUINO_PORT_TO_INPUT	KEYWORD2
ARDUINO_PIN_TO_PORT	KEYWORD2
ARDUINO_PIN_TO_MASK	KEYWORD2

InitGPIO	KEYWORD2

GetPinMode	KEYWORD2
SetPinMode	KEYWORD2
CheckPinSet	KEYWORD2
CheckPinUnset	KEYWORD2
ReadPin	KEYWORD2
CheckPin	KEYWORD2
WritePin	KEYWORD2
SetPin	KEYWORD2
ClearPin	KEYWORD2
TogglePin	KEYWORD2
ResetPin	KEYWORD2

ARDUINO_PIN_OUT_REF	KEYWORD2
ARDUINO_PIN_IN_REF	KEYWORD2
CHECK_ARDUINO_PIN_SET	KEYWORD2
READ_ARDUINO_PIN	KEYWORD2
CHECK_ARDUINO_PIN	KEYWORD2
CHECK_ARDUINO_PIN_UNSET	KEYWORD2
WRITE_ARDUINO_PIN	KEYWORD2
SET_ARDUINO_PIN	KEYWORD2
CLEAR_ARDUINO_PIN	KEYWORD2
TOGGLE_ARDUINO_PIN	KEYWORD2
RESET_ARDUINO_PIN	KEYWORD2
GET_ARDUINO_PIN_MODE	KEYWORD2
SET_ARDUINO_PIN_MODE	KEYWORD2


# GPIO_portpins

PORT_PIN_PAIR	KEYWORD2
CHECK_PIN	KEYWORD2
CHECK_PIN_SET	KEYWORD2
CHECK_PIN_UNSET	KEYWORD2
SET_PIN	KEYWORD2
CLEAR_PIN	KEYWORD2
TOGGLE_PIN	KEYWORD2
PIN_IN_CHECK	KEYWORD2
PIN_IN_CHECK_SET	KEYWORD2
PIN_IN_CHECK_UNSET	KEYWORD2
PIN_OUT_SET	KEYWORD2
PIN_OUT_CLEAR	KEYWORD2
PIN_OUT_TOGGLE	KEYWORD2
PIN_RESET	KEYWORD2
PIN_GET_MODE	KEYWORD2
PIN_SET_MODE	KEYWORD2



# Control



# Data

# datum

DataSize	KEYWORD2
DataTypeFormat	KEYWORD2
DataType	KEYWORD2

DataTypeToDataSize	KEYWORD2

StringInsertValue	KEYWORD2
StringReadValue	KEYWORD2

# params

ParamFromBytes	KEYWORD2
ParamFromString	KEYWORD2

# fields

FieldFromBytes	KEYWORD2
FieldFromString	KEYWORD2



# Communication

# messages

MESSAGE_MARKER	KEYWORD2

ReadBuffer	KEYWORD2
Read	KEYWORD2

MessageHandler	KEYWORD2

MessageFromBytes	KEYWORD2
MessageFromString	KEYWORD2

WaitForMessage	KEYWORD2


# print

FlushAndDelay	KEYWORD2
PrintBytes	KEYWORD2
PrintBytesAndFlush	KEYWORD2
PrintBit	KEYWORD2
PrintBitLine	KEYWORD2
PrintVal	KEYWORD2
PrintLine	KEYWORD2
PrintString	KEYWORD2



# Storage

# EEPROM_I2C

SerialEEPROMChipFamily	KEYWORD2



# Database





#######################################
# Constants & Enum Values(LITERAL1)
#######################################

# Types

# aliases

null	LITERAL1
NULL	LITERAL1
TRUE	LITERAL1
FALSE	LITERAL1


# util

BITS_PER_BYTE	LITERAL1
kilo	LITERAL1
kilobit	LITERAL1
KILO	LITERAL1
KILOBYTE	LITERAL1
KILObit	LITERAL1
mega	LITERAL1
megabit	LITERAL1
MEGA	LITERAL1
MEGABYTE	LITERAL1



# IO

# GPIO

TRISTATE_INPUT	LITERAL1
L	LITERAL1
H	LITERAL1
HIGH_Z	LITERAL1
DISCONNECTED	LITERAL1

Input	LITERAL1
FloatingInput	LITERAL1
TriStateInput	LITERAL1
OpenDrainFloat	LITERAL1
PullUp	LITERAL1
PullUpInput	LITERAL1
BinaryInput	LITERAL1
OpenDrainHigh	LITERAL1
PullupInput	LITERAL1
OutputLow	LITERAL1
CurrentSink	LITERAL1
OpenDrainLow	LITERAL1
Output	LITERAL1
OutputHigh	LITERAL1
CurrentSource	LITERAL1


# Control



# Data

# datum

SERIAL_DEFAULT_TIMEOUT_MS	LITERAL1

VAR_LENGTH	LITERAL1
ONE_BYTE	LITERAL1
TWO_BYTES	LITERAL1
THREE_BYTES	LITERAL1
FOUR_BYTES	LITERAL1
UNSIGNED_DATA_TYPE	LITERAL1
SIGNED_DATA_TYPE	LITERAL1
SPECIAL_DATA_TYPE	LITERAL1
BYTES_DATUM	LITERAL1
STRING_DATUM	LITERAL1
BIT_DATUM	LITERAL1
BYTE_DATUM	LITERAL1
CHAR_DATUM	LITERAL1
BOOL_DATUM	LITERAL1
WORD_DATUM	LITERAL1
SHORT_DATUM	LITERAL1
DWORD_DATUM	LITERAL1
LONG_DATUM	LITERAL1
FLOAT_DATUM	LITERAL1



# Communication

# print

SERIAL_PRINT_DELAY_MS	LITERAL1
DEFAULT_SERIAL	LITERAL1
ON_STRING	LITERAL1
FALSE_STRING	LITERAL1


# Storage

# EEPROM_I2C

SERIAL_EEPROM_DEFAULT_I2C_ADDRESS	LITERAL1
SERIAL_EEPROM_TIMEOUT_MS	LITERAL1
SERIAL_EEPROM_WAIT_DELAY_MS	LITERAL1
SERIAL_EEPROM_ERASE_VALUE	LITERAL1

UNKNOWN_EEPROM_CHIP	LITERAL1
AT24C01	LITERAL1
AT24C02	LITERAL1
AT24C04	LITERAL1
AT24C08	LITERAL1
AT24C16	LITERAL1
AT24C32	LITERAL1
AT24C64	LITERAL1
AT24C128	LITERAL1
AT24C256	LITERAL1
AT24C512	LITERAL1
AT24C1024	LITERAL1
AT24CM01	LITERAL1
AT24CM02	LITERAL1
mc24XX01	LITERAL1
mc24XX02	LITERAL1
mc24XX04	LITERAL1
mc24XX08	LITERAL1
mc24XX16	LITERAL1
mc24XX32	LITERAL1
mc24XX64	LITERAL1
mc24XX128	LITERAL1
mc24XX256	LITERAL1
mc24XX512	LITERAL1
mc24XX102x	LITERAL1


# Database
